

NO		./norte    
	 SO ../sur

		 F 16,  37, 220 

  EA   este
C				 0,		0, 255		
			WE				/oeste			   

     
  
             
  
       11111111111       
      10000000001
    11111100000111
    100000000100011
    100000000110001
  11000000000000001 
  10000000000000001
  11111111111111111
