

NO		./norte    
	 SO ../sur

		 F 16,  37, 220 

  EA   este
C				 0,		0, 255		
			WE				/oeste			   

     
  
             
  
       11111111111       
      10000000001
    11111100000111
    100000010100011  11
    1000011 1110001  101
  1100001111000000111101
  10000000000000000000001
  11111111111111111100001
                 1100001
                 1000011
                  1111
