NO ./assets/blue_glazed_terracotta.png
WE ./assets/basalt_side.png
SO ./assets/chiseled_red_sandstone.png
EA ./assets/cracked_deepslate_tiles.png

F 56, 128, 30
C 40, 78, 200
  
       11111111111       
      10000000001
    11111100000111
    100000010100011  11
    1000011 1110001  101
  1100001111000000111101
  10000000000000000000001
  11111111111111111100001
                 1100N01
                 1000011
                  1111
