NO ./assets/blue_glazed_terracotta.png
WE ./assets/basalt_side.png
SO ./assets/chiseled_red_sandstone.png
EA ./assets/cracked_deepslate_tiles.png

F 164, 194, 165
C 202, 233, 250
  
       11111111111            11111
      10000000001             10001
    11111100000111            10N01
    100000010100011  11       10001
    1000011 1110001  101      11111
  1100001111000000111101
  10000000000000000000001
  11111111111111111100001
                 1100101
                 1000011
                  1111
