11111111111111111111111
10000100000B00000000011
10000111111111111C0B001
10P00B001000B00011100E1
10000100101111100010111
100001C0000B0000000C001
11111111111111111111111
